https://www.calculator.net/sitemap.html

Mortgage Calculator	Loan Calculator
Auto Loan Calculator	Interest Calculator
Payment Calculator	Retirement Calculator
Amortization Calculator	Investment Calculator
Currency Calculator	Inflation Calculator
Finance Calculator	Mortgage Payoff Calculator
Income Tax Calculator	Compound Interest Calculator
Salary Calculator	401K Calculator
Interest Rate Calculator	Sales Tax Calculator
House Affordability Calculator	Savings Calculator
Rent Calculator	Marriage Tax Calculator
Estate Tax Calculator	Pension Calculator
Social Security Calculator	Annuity Calculator
Annuity Payout Calculator	Credit Card Calculator
Credit Cards Payoff Calculator	Debt Payoff Calculator
Debt Consolidation Calculator	Repayment Calculator
Student Loan Calculator	College Cost Calculator
Simple Interest Calculator	CD Calculator
Bond Calculator	Roth IRA Calculator
IRA Calculator	RMD Calculator
VAT Calculator	Cash Back or Low Interest Calculator
Auto Lease Calculator	Depreciation Calculator
Average Return Calculator	Margin Calculator
Discount Calculator	Business Loan Calculator
Debt-to-Income Ratio Calculator	Real Estate Calculator
Take-Home-Paycheck Calculator	Personal Loan Calculator
Boat Loan Calculator	Lease Calculator
Refinance Calculator	Budget Calculator
Rental Property Calculator	IRR Calculator
ROI Calculator	APR Calculator
FHA Loan Calculator	VA Mortgage Calculator
Down Payment Calculator	Rent vs. Buy Calculator
Payback Period Calculator	Present Value Calculator
Future Value Calculator	Commission Calculator
Mortgage Calculator UK	Canadian Mortgage Calculator
Mortgage Amortization Calculator	Percent Off Calculator